id,id_caller,id_receiver,start_date,duration,end_date,id_cellsite
1,36,62,1660408262,1533,1660409795,42
2,38,93,1634744023,1913,1634745936,11
3,43,74,1657053222,2924,1657056146,20
4,47,76,1633428980,3754,1633432734,8
5,50,90,1643625772,3055,1643628827,40
6,7,87,1637528375,2624,1637530999,39
7,34,83,1646201307,1468,1646202775,42
8,30,91,1630161392,2916,1630164308,32
9,26,65,1642886476,1192,1642887668,18
10,26,90,1639290672,382,1639291054,19
11,36,83,1631800352,4063,1631804415,4
12,45,86,1656782962,3092,1656786054,18
13,35,51,1646996760,808,1646997568,18
14,20,80,1660805434,2636,1660808070,2
15,18,78,1646687986,921,1646688907,23
16,50,88,1633674485,2137,1633676622,4
17,5,82,1657531905,564,1657532469,26
18,35,54,1654207341,4837,1654212178,35
19,38,69,1644672901,4901,1644677802,7
20,22,64,1655448292,1416,1655449708,40
21,1,52,1658076819,308,1658077127,48
22,1,63,1642355874,2137,1642358011,18
23,15,51,1644583546,4362,1644587908,42
24,31,66,1648663105,711,1648663816,36
25,19,86,1646330208,4082,1646334290,21
26,16,75,1630199877,4110,1630203987,1
27,16,89,1638114778,1141,1638115919,3
28,29,75,1651787050,2852,1651789902,27
29,38,66,1633190876,997,1633191873,27
30,50,65,1636379700,524,1636380224,31
31,40,86,1637354544,828,1637355372,40
32,39,58,1648259202,4800,1648264002,24
33,21,80,1657749854,4714,1657754568,9
34,39,63,1650014642,3356,1650017998,7
35,23,74,1644105006,4280,1644109286,19
36,3,88,1654425216,4529,1654429745,37
37,49,85,1654522815,2972,1654525787,9
38,7,88,1635599397,890,1635600287,50
39,14,94,1654127621,2141,1654129762,45
40,10,85,1639928519,3333,1639931852,36
41,30,65,1643387955,3127,1643391082,16
42,41,81,1650925174,848,1650926022,29
43,37,63,1656301854,3843,1656305697,26
44,3,58,1641132491,3032,1641135523,38
45,31,98,1652781219,1632,1652782851,23
46,3,86,1638865949,4361,1638870310,22
47,3,94,1632433214,4388,1632437602,38
48,19,55,1631802628,4384,1631807012,19
49,34,66,1645806204,2984,1645809188,50
50,27,92,1632944284,209,1632944493,23
51,14,85,1634179553,872,1634180425,3
52,26,82,1655870026,1559,1655871585,4
53,26,76,1634599608,4405,1634604013,49
54,11,79,1659403739,4554,1659408293,38
55,13,53,1629667646,4833,1629672479,48
56,13,84,1642168611,980,1642169591,2
57,33,72,1636739959,749,1636740708,47
58,41,72,1630246452,4713,1630251165,38
59,43,82,1638966273,469,1638966742,5
60,12,56,1637282419,1462,1637283881,16
61,29,62,1633706190,2163,1633708353,29
62,23,51,1655770376,4160,1655774536,26
63,12,62,1631600498,3969,1631604467,44
64,22,82,1649819650,3055,1649822705,10
65,22,97,1656644342,875,1656645217,45
66,1,60,1655820983,1912,1655822895,31
67,21,53,1630173059,4261,1630177320,29
68,13,65,1647533420,3418,1647536838,39
69,45,65,1653724789,2253,1653727042,50
70,43,88,1660923009,529,1660923538,34
71,1,80,1640646556,4398,1640650954,39
72,21,54,1646766368,2796,1646769164,5
73,16,58,1631001540,724,1631002264,14
74,43,83,1652874792,4398,1652879190,27
75,18,69,1660924186,1810,1660925996,26
76,34,81,1644322925,4268,1644327193,39
77,11,79,1649326560,2818,1649329378,19
78,28,88,1639625361,3446,1639628807,19
79,22,69,1649974181,1470,1649975651,16
80,23,54,1630070717,2019,1630072736,2
81,4,94,1659372142,1056,1659373198,37
82,24,84,1644384567,3231,1644387798,2
83,26,96,1650572482,1403,1650573885,36
84,23,93,1637931348,1490,1637932838,25
85,5,99,1654195362,3806,1654199168,35
86,49,96,1658133272,4613,1658137885,22
87,40,72,1634001620,3166,1634004786,30
88,44,75,1640092764,2331,1640095095,27
89,30,55,1641443231,1838,1641445069,15
90,10,58,1650103276,1230,1650104506,4
91,16,97,1645989312,4509,1645993821,10
92,48,92,1660725613,1283,1660726896,8
93,19,80,1654812726,2280,1654815006,21
94,38,59,1637384555,1738,1637386293,1
95,50,67,1633525607,1672,1633527279,2
96,2,97,1633426315,1582,1633427897,44
97,36,86,1649237265,2705,1649239970,1
98,6,83,1650900667,1987,1650902654,26
99,15,64,1632111477,1227,1632112704,16
100,45,72,1636579251,2755,1636582006,36
101,46,83,1657913789,2191,1657915980,24
102,4,53,1660800861,4976,1660805837,37
103,23,64,1656403491,4636,1656408127,33
104,46,67,1634754417,1464,1634755881,37
105,35,81,1636661695,4517,1636666212,13
106,3,52,1645584243,2908,1645587151,48
107,34,67,1634439720,1557,1634441277,41
108,20,92,1630693726,440,1630694166,35
109,40,97,1656130553,835,1656131388,47
110,42,98,1649488591,2025,1649490616,18
111,17,96,1642627702,4268,1642631970,43
112,21,96,1655035257,3885,1655039142,26
113,5,72,1631040105,3600,1631043705,29
114,37,80,1636833119,2940,1636836059,22
115,28,77,1638583834,2298,1638586132,4
116,50,92,1659151546,4645,1659156191,25
117,27,72,1655528374,4436,1655532810,49
118,47,92,1655792521,334,1655792855,42
119,46,62,1635499707,3103,1635502810,42
120,21,70,1634481778,4238,1634486016,23
121,1,63,1649831064,4625,1649835689,37
122,6,82,1635085549,344,1635085893,10
123,25,70,1637351757,1401,1637353158,32
124,17,68,1629837082,2671,1629839753,14
125,35,64,1633147814,199,1633148013,44
126,16,66,1660630495,631,1660631126,23
127,20,85,1651148782,1656,1651150438,21
128,4,90,1641882311,4550,1641886861,26
129,10,55,1649790701,3466,1649794167,40
130,14,85,1638908981,3278,1638912259,20
131,33,82,1649271249,3509,1649274758,14
132,27,58,1654549738,4047,1654553785,10
133,49,79,1640536167,3615,1640539782,38
134,32,58,1658410387,1063,1658411450,15
135,31,64,1633047176,4507,1633051683,21
136,25,52,1649137337,3461,1649140798,28
137,40,69,1660589974,374,1660590348,14
138,6,59,1631825216,2962,1631828178,3
139,31,56,1642084294,2797,1642087091,21
140,42,63,1638675271,1407,1638676678,50
141,12,84,1633895849,3096,1633898945,34
142,49,99,1640355650,621,1640356271,27
143,46,81,1656490361,533,1656490894,35
144,11,76,1635647043,3697,1635650740,11
145,43,74,1655019242,2505,1655021747,38
146,28,85,1656456898,1085,1656457983,37
147,40,81,1634177113,4597,1634181710,7
148,44,97,1649432971,2436,1649435407,6
149,41,69,1653241901,1288,1653243189,21
150,7,70,1657551580,1398,1657552978,7
151,30,59,1652422377,1801,1652424178,20
152,37,98,1637284538,3228,1637287766,29
153,49,85,1641028525,1372,1641029897,26
154,27,57,1654545168,2773,1654547941,1
155,28,78,1636081662,622,1636082284,16
156,40,57,1646122867,807,1646123674,11
157,12,95,1639008791,4483,1639013274,44
158,11,99,1639010673,4869,1639015542,20
159,36,71,1639181855,2361,1639184216,42
160,11,56,1650149093,3789,1650152882,36
161,49,81,1633646606,1438,1633648044,6
162,47,84,1651683773,4559,1651688332,10
163,13,99,1649194803,1861,1649196664,48
164,50,92,1647689376,1618,1647690994,42
165,7,93,1652297683,1272,1652298955,13
166,34,52,1656783657,1607,1656785264,7
167,36,82,1649292628,3355,1649295983,42
168,12,64,1634782946,959,1634783905,32
169,6,56,1659507785,2412,1659510197,3
170,11,91,1636502551,1794,1636504345,29
171,45,75,1643582162,2542,1643584704,4
172,46,60,1629818429,2871,1629821300,11
173,30,64,1652117513,3913,1652121426,35
174,39,81,1661093868,2079,1661095947,34
175,24,87,1650443385,2127,1650445512,31
176,39,92,1634993630,477,1634994107,43
177,16,77,1654132388,4720,1654137108,25
178,14,71,1639507498,3478,1639510976,34
179,32,78,1654839325,905,1654840230,34
180,31,94,1639165577,552,1639166129,19
181,43,62,1646777829,2877,1646780706,26
182,12,75,1660240846,4480,1660245326,6
183,37,67,1637671743,2143,1637673886,44
184,42,88,1631178069,2184,1631180253,14
185,30,53,1649472946,383,1649473329,17
186,8,52,1652184685,994,1652185679,19
187,16,92,1632474972,4555,1632479527,20
188,11,84,1631831225,4991,1631836216,9
189,42,71,1645360511,2359,1645362870,39
190,15,85,1648978867,2902,1648981769,17
191,18,79,1651488819,467,1651489286,23
192,40,80,1635224121,466,1635224587,28
193,49,59,1648978149,4146,1648982295,24
194,44,76,1659615121,3376,1659618497,9
195,14,66,1644594872,184,1644595056,35
196,39,99,1643769747,1643,1643771390,20
197,31,59,1640257521,946,1640258467,1
198,20,71,1637811051,4507,1637815558,15
199,7,96,1660563202,643,1660563845,14
200,39,67,1636590193,846,1636591039,50
201,38,91,1648476482,3251,1648479733,40
202,23,60,1632562502,3393,1632565895,38
203,3,74,1647634479,1599,1647636078,13
204,28,62,1643577443,1643,1643579086,35
205,18,83,1655603737,659,1655604396,3
206,4,52,1632136581,1806,1632138387,23
207,48,63,1647723755,1384,1647725139,8
208,41,57,1657058526,1053,1657059579,12
209,22,71,1657841414,4569,1657845983,21
210,14,60,1653784007,3374,1653787381,39
211,29,76,1646160697,563,1646161260,16
212,49,54,1638354874,2283,1638357157,29
213,33,72,1646417555,1383,1646418938,26
214,24,74,1640871373,1647,1640873020,6
215,24,54,1642934368,4383,1642938751,35
216,34,98,1636662997,4694,1636667691,49
217,11,91,1646307226,1649,1646308875,26
218,14,86,1635738799,822,1635739621,13
219,16,73,1644533343,4672,1644538015,20
220,28,64,1643885156,4679,1643889835,27
221,29,54,1633269719,1846,1633271565,25
222,8,75,1644251975,3606,1644255581,40
223,45,75,1629881308,3162,1629884470,15
224,37,68,1646216981,4695,1646221676,19
225,50,72,1654561057,2869,1654563926,2
226,36,95,1653292546,4218,1653296764,5
227,34,99,1641662656,4297,1641666953,9
228,28,93,1637402417,3930,1637406347,39
229,6,52,1639263292,1968,1639265260,21
230,49,97,1648549461,1803,1648551264,21
231,45,73,1640061109,563,1640061672,3
232,37,52,1637434110,2596,1637436706,33
233,7,60,1638591755,4023,1638595778,8
234,12,83,1658263038,3478,1658266516,43
235,41,57,1636551473,4098,1636555571,8
236,16,69,1646321132,4549,1646325681,42
237,7,56,1632521678,784,1632522462,47
238,41,94,1656759498,1705,1656761203,32
239,15,74,1642200104,2874,1642202978,11
240,20,88,1642824007,2770,1642826777,44
241,32,63,1657202130,4603,1657206733,22
242,10,91,1639447593,3521,1639451114,17
243,13,89,1638974342,2800,1638977142,4
244,45,52,1649841694,1100,1649842794,30
245,14,52,1649091353,172,1649091525,42
246,28,86,1633599440,1596,1633601036,24
247,47,79,1634653256,667,1634653923,33
248,48,63,1642586293,2224,1642588517,12
249,24,52,1636646366,1091,1636647457,1
250,16,57,1633152137,2720,1633154857,49
251,10,94,1633701032,1614,1633702646,26
252,17,83,1653721931,2309,1653724240,48
253,23,89,1638653123,189,1638653312,25
254,4,63,1657923872,3600,1657927472,29
255,39,56,1650389912,3058,1650392970,24
256,40,64,1630273415,1138,1630274553,40
257,14,88,1642394599,976,1642395575,17
258,18,79,1655816476,921,1655817397,10
259,48,71,1638929815,2639,1638932454,47
260,23,58,1648491286,682,1648491968,4
261,41,88,1653836264,4672,1653840936,31
262,9,89,1633314419,3429,1633317848,17
263,1,73,1653589870,730,1653590600,17
264,48,63,1634015411,3132,1634018543,23
265,18,76,1655033456,693,1655034149,31
266,35,63,1633971499,1970,1633973469,23
267,20,70,1634026024,391,1634026415,47
268,10,71,1635569389,949,1635570338,13
269,13,67,1651368773,1849,1651370622,26
270,16,58,1655279551,1994,1655281545,34
271,5,89,1645162746,4102,1645166848,21
272,10,76,1647756935,3543,1647760478,10
273,5,61,1632553386,3183,1632556569,12
274,43,91,1646685936,543,1646686479,7
275,24,87,1629877944,2706,1629880650,20
276,17,52,1658013959,1170,1658015129,39
277,25,78,1643583650,2967,1643586617,49
278,30,54,1652093520,3007,1652096527,26
279,46,71,1638277008,1370,1638278378,34
280,43,58,1637955555,4203,1637959758,13
281,50,93,1659329246,2125,1659331371,5
282,23,98,1660277027,2186,1660279213,16
283,29,54,1640154015,216,1640154231,38
284,1,89,1656190139,2619,1656192758,14
285,8,54,1640209414,3609,1640213023,31
286,19,68,1658140093,608,1658140701,25
287,33,87,1638135766,1672,1638137438,24
288,48,82,1647219065,2949,1647222014,7
289,21,79,1655457996,296,1655458292,21
290,6,52,1642528426,3011,1642531437,34
291,13,56,1649780431,430,1649780861,37
292,42,56,1654170074,3870,1654173944,1
293,30,70,1655591613,2612,1655594225,50
294,8,83,1658239737,1611,1658241348,27
295,39,81,1638343891,3277,1638347168,21
296,41,73,1653282043,4845,1653286888,15
297,50,90,1650209352,2645,1650211997,42
298,9,60,1650313122,3030,1650316152,29
299,8,65,1646919948,3406,1646923354,41
300,15,97,1660321900,957,1660322857,41
301,41,93,1638431146,2802,1638433948,23
302,44,90,1631939843,1312,1631941155,41
303,7,69,1647746373,3291,1647749664,8
304,43,82,1655315219,2934,1655318153,50
305,47,90,1649509218,3297,1649512515,33
306,7,75,1651458134,1336,1651459470,48
307,50,70,1641162474,2964,1641165438,40
308,17,88,1634392972,995,1634393967,27
309,28,66,1656570696,347,1656571043,11
310,43,91,1652306443,2949,1652309392,31
311,36,71,1651744709,139,1651744848,41
312,29,82,1652020037,3186,1652023223,21
313,38,64,1630962365,2720,1630965085,30
314,50,80,1645413273,303,1645413576,20
315,4,63,1658744908,655,1658745563,30
316,13,86,1655903722,3359,1655907081,21
317,45,72,1650834597,3146,1650837743,49
318,42,93,1638006510,4354,1638010864,29
319,47,61,1643483262,4621,1643487883,45
320,36,84,1652594343,2309,1652596652,19
321,4,58,1647863193,1586,1647864779,40
322,3,57,1657083055,2923,1657085978,27
323,10,79,1648182281,1853,1648184134,37
324,26,82,1650036870,727,1650037597,41
325,42,61,1644159980,3018,1644162998,35
326,50,99,1634335202,2102,1634337304,37
327,10,90,1660621572,4660,1660626232,23
328,26,62,1656138722,1531,1656140253,41
329,35,93,1648781182,4388,1648785570,50
330,37,79,1647926823,3698,1647930521,38
331,1,59,1653910322,4797,1653915119,15
332,28,81,1637256177,4146,1637260323,48
333,4,91,1635136717,2265,1635138982,50
334,33,90,1636079710,4185,1636083895,15
335,25,61,1653463305,2675,1653465980,15
336,28,92,1638092469,2447,1638094916,33
337,12,96,1657516422,1004,1657517426,6
338,36,65,1641497595,3222,1641500817,8
339,46,72,1657400229,3142,1657403371,8
340,30,73,1657788923,4985,1657793908,50
341,41,64,1645650063,2200,1645652263,29
342,44,63,1660657445,3879,1660661324,24
343,29,81,1651387012,2657,1651389669,17
344,29,70,1646136674,1811,1646138485,18
345,45,69,1646072235,3621,1646075856,28
346,11,86,1646440121,3697,1646443818,13
347,3,64,1645843157,3443,1645846600,34
348,18,76,1638744714,2104,1638746818,9
349,26,59,1634730819,2080,1634732899,13
350,44,94,1656296485,1636,1656298121,43
351,26,88,1653375256,4235,1653379491,40
352,15,65,1638335847,4887,1638340734,39
353,19,84,1644881835,2245,1644884080,7
354,20,83,1640129666,2433,1640132099,30
355,48,98,1631833717,4959,1631838676,39
356,23,74,1661012311,2755,1661015066,13
357,1,70,1644385681,1559,1644387240,24
358,18,94,1642428341,4983,1642433324,12
359,32,75,1646259964,934,1646260898,37
360,20,90,1661047567,4462,1661052029,21
361,3,82,1637173482,4746,1637178228,6
362,20,59,1660677506,4932,1660682438,41
363,12,68,1632122133,2071,1632124204,16
364,1,57,1638508712,614,1638509326,19
365,7,51,1634667077,3435,1634670512,2
366,16,51,1651872646,3616,1651876262,32
367,41,55,1634783818,2663,1634786481,49
368,11,95,1659108050,1403,1659109453,18
369,39,72,1643343729,2713,1643346442,27
370,3,74,1639836727,4922,1639841649,35
371,21,98,1652098028,4906,1652102934,29
372,8,58,1653728540,2090,1653730630,6
373,41,84,1644102659,1473,1644104132,1
374,10,73,1647178881,785,1647179666,44
375,26,60,1639625289,1069,1639626358,9
376,39,75,1653721075,4103,1653725178,6
377,15,76,1640278574,996,1640279570,35
378,9,55,1653534144,3627,1653537771,14
379,4,76,1656267000,610,1656267610,12
380,24,94,1637890131,4847,1637894978,11
381,4,87,1646162506,181,1646162687,27
382,8,64,1656254762,3395,1656258157,4
383,27,64,1650980534,1779,1650982313,7
384,17,81,1640270744,2287,1640273031,14
385,36,79,1630005129,2885,1630008014,30
386,49,83,1658171891,641,1658172532,2
387,35,81,1631746192,390,1631746582,5
388,7,64,1659683744,4461,1659688205,13
389,7,55,1632728763,849,1632729612,38
390,22,86,1638824520,1975,1638826495,26
391,24,65,1646616846,3496,1646620342,41
392,46,57,1629824428,2025,1629826453,21
393,15,73,1646380487,2650,1646383137,38
394,5,73,1637667805,3079,1637670884,16
395,10,62,1638902995,2434,1638905429,32
396,44,84,1640175232,2850,1640178082,38
397,41,95,1647166194,3444,1647169638,38
398,13,67,1640852815,4946,1640857761,50
399,17,70,1632915688,546,1632916234,42
400,49,89,1642537324,4350,1642541674,31
401,44,85,1640964477,4424,1640968901,21
402,47,93,1647234947,1895,1647236842,41
403,29,57,1638304208,452,1638304660,14
404,20,66,1648152226,4721,1648156947,41
405,46,69,1645544637,3954,1645548591,48
406,15,53,1658233274,2290,1658235564,2
407,23,60,1652481077,1797,1652482874,47
408,1,59,1659237374,1126,1659238500,15
409,45,72,1660018295,4697,1660022992,13
410,49,97,1643303700,250,1643303950,48
411,20,78,1657281633,4554,1657286187,26
412,50,53,1635892864,3487,1635896351,41
413,13,75,1652785554,3436,1652788990,15
414,19,80,1659367422,2667,1659370089,13
415,13,63,1658750612,1101,1658751713,31
416,37,79,1630171138,1988,1630173126,9
417,38,70,1643049655,1901,1643051556,5
418,27,88,1642447715,3034,1642450749,50
419,12,56,1631315958,4496,1631320454,41
420,33,93,1658866144,3286,1658869430,15
421,17,96,1651655239,300,1651655539,15
422,33,67,1657682353,2234,1657684587,18
423,41,67,1637481538,2621,1637484159,21
424,37,81,1639879773,3883,1639883656,42
425,45,87,1648461712,964,1648462676,1
426,17,80,1652522986,3751,1652526737,21
427,32,62,1642980632,4883,1642985515,18
428,13,68,1646302093,2709,1646304802,42
429,50,77,1632873528,1663,1632875191,5
430,30,52,1652781082,182,1652781264,19
431,18,63,1643477377,4480,1643481857,28
432,23,88,1650539343,1643,1650540986,11
433,40,83,1630046151,2453,1630048604,33
434,7,81,1657263578,2668,1657266246,22
435,46,68,1657289758,709,1657290467,5
436,20,97,1638676633,4457,1638681090,44
437,33,59,1656897681,668,1656898349,32
438,13,78,1635055324,2563,1635057887,19
439,26,65,1637801982,3527,1637805509,32
440,24,64,1659273002,4452,1659277454,29
441,19,56,1652374587,519,1652375106,27
442,16,66,1660008178,3434,1660011612,47
443,12,68,1637053218,813,1637054031,30
444,33,78,1660257016,1353,1660258369,17
445,9,95,1659870440,4954,1659875394,25
446,11,64,1648570961,3542,1648574503,24
447,46,56,1641826565,481,1641827046,40
448,42,53,1643911287,1944,1643913231,24
449,24,78,1631406043,1022,1631407065,16
450,33,80,1653584738,289,1653585027,11
451,19,57,1649955580,3327,1649958907,33
452,26,67,1656628156,4322,1656632478,34
453,25,59,1630703995,2334,1630706329,25
454,20,90,1641538380,1340,1641539720,45
455,6,95,1655352702,4451,1655357153,23
456,24,70,1642155532,3278,1642158810,28
457,11,88,1652999790,790,1653000580,22
458,31,72,1647599072,642,1647599714,45
459,20,74,1637078406,1196,1637079602,10
460,5,68,1636157636,3164,1636160800,3
461,22,73,1647271129,3568,1647274697,46
462,24,56,1640692265,371,1640692636,40
463,1,73,1657601949,434,1657602383,4
464,47,56,1656936670,2307,1656938977,24
465,18,54,1647820209,3299,1647823508,17
466,40,79,1654557800,3849,1654561649,40
467,20,92,1660578897,2205,1660581102,11
468,36,79,1634702847,338,1634703185,45
469,46,94,1631895357,2195,1631897552,45
470,23,65,1645614628,443,1645615071,15
471,22,89,1636079501,4749,1636084250,4
472,33,77,1646521002,4948,1646525950,42
473,5,67,1646140694,4136,1646144830,22
474,15,88,1653570775,1857,1653572632,34
475,20,97,1639209416,4184,1639213600,17
476,18,52,1642085271,3112,1642088383,48
477,14,60,1645345212,3770,1645348982,41
478,41,77,1637700675,685,1637701360,27
479,35,70,1646277126,3034,1646280160,1
480,5,62,1637078489,3326,1637081815,42
481,9,77,1655272356,3300,1655275656,40
482,3,59,1641570856,3463,1641574319,49
483,27,69,1635766583,1116,1635767699,15
484,46,74,1642489506,1118,1642490624,30
485,7,80,1651626800,1094,1651627894,9
486,41,98,1643000145,2690,1643002835,1
487,38,83,1647548156,173,1647548329,5
488,31,83,1648173153,4160,1648177313,42
489,28,67,1638720027,4948,1638724975,43
490,33,90,1650423327,2996,1650426323,38
491,38,57,1651280639,3289,1651283928,24
492,41,85,1659230939,4920,1659235859,34
493,28,60,1643580695,1717,1643582412,48
494,19,61,1632791225,2996,1632794221,6
495,31,87,1650563978,4097,1650568075,44
496,10,55,1645377015,2774,1645379789,2
497,44,61,1644751965,3927,1644755892,34
498,9,89,1654494548,4319,1654498867,19
499,41,67,1636103994,1521,1636105515,12
500,8,87,1641114237,2471,1641116708,28
501,33,95,1659088902,4297,1659093199,44
502,10,59,1629947230,4760,1629951990,19
503,9,81,1658931366,3704,1658935070,45
504,7,67,1633608185,3082,1633611267,32
505,30,58,1643333275,1057,1643334332,36
506,40,79,1655296179,1189,1655297368,35
507,19,98,1629783823,2623,1629786446,9
508,31,54,1631779400,1513,1631780913,26
509,24,78,1659161279,4748,1659166027,4
510,6,68,1643435604,1233,1643436837,10
511,18,97,1631680327,4175,1631684502,45
512,4,80,1658257723,3335,1658261058,28
513,21,89,1644944098,3951,1644948049,4
514,6,77,1630957946,4220,1630962166,31
515,47,79,1641448506,3478,1641451984,31
516,20,63,1634557514,544,1634558058,48
517,34,59,1645638765,623,1645639388,3
518,27,74,1638582475,3831,1638586306,43
519,34,83,1656643180,2848,1656646028,5
520,32,51,1640966413,4811,1640971224,2
521,37,64,1638472539,2996,1638475535,50
522,29,91,1654271138,4540,1654275678,34
523,41,77,1630828545,4496,1630833041,14
524,13,83,1645599363,4048,1645603411,23
525,17,69,1652993993,3583,1652997576,25
526,21,68,1629637679,116,1629637795,45
527,27,57,1646974856,889,1646975745,38
528,31,97,1641093221,1586,1641094807,31
529,28,77,1657912386,390,1657912776,1
530,7,91,1643217811,3068,1643220879,45
531,6,87,1640536032,2363,1640538395,11
532,16,58,1632600825,1064,1632601889,30
533,49,61,1637135048,986,1637136034,35
534,29,70,1655542534,2737,1655545271,9
535,14,95,1645246576,3857,1645250433,46
536,45,59,1649246800,2747,1649249547,19
537,27,51,1652324808,1176,1652325984,45
538,7,78,1649790739,1443,1649792182,27
539,44,58,1653257456,314,1653257770,43
540,16,89,1645495791,375,1645496166,11
541,46,63,1655630230,4595,1655634825,3
542,41,79,1633312496,1774,1633314270,19
543,45,91,1657708044,3350,1657711394,18
544,49,78,1649701331,1106,1649702437,45
545,25,77,1649486513,459,1649486972,11
546,14,83,1651027448,3581,1651031029,25
547,39,78,1630972883,715,1630973598,25
548,11,99,1630108058,632,1630108690,41
549,42,72,1652034906,2662,1652037568,16
550,7,83,1655276419,2982,1655279401,16
551,28,86,1656512459,2214,1656514673,12
552,26,99,1638437646,3532,1638441178,23
553,39,83,1640688257,821,1640689078,9
554,6,94,1657824289,2642,1657826931,42
555,38,87,1655699878,4333,1655704211,20
556,40,58,1635596645,4129,1635600774,21
557,27,77,1636256256,3172,1636259428,40
558,38,88,1635068624,3197,1635071821,32
559,50,86,1632891714,2928,1632894642,50
560,6,59,1642104277,829,1642105106,37
561,22,88,1656760602,4161,1656764763,30
562,34,54,1653253524,135,1653253659,13
563,34,62,1639395114,265,1639395379,48
564,7,70,1640209684,3157,1640212841,44
565,29,78,1638645058,1211,1638646269,25
566,2,78,1656863268,3018,1656866286,12
567,49,61,1642584693,3079,1642587772,40
568,13,64,1643028405,1132,1643029537,38
569,31,78,1647625535,3512,1647629047,43
570,40,64,1655387936,1360,1655389296,32
571,47,58,1643646078,1556,1643647634,28
572,47,55,1653778508,1356,1653779864,6
573,5,58,1657425588,463,1657426051,11
574,31,54,1631148288,4303,1631152591,13
575,48,53,1645900783,740,1645901523,10
576,19,86,1640303537,3483,1640307020,48
577,11,81,1647268439,4529,1647272968,8
578,46,68,1652887917,4733,1652892650,8
579,13,70,1637718716,1840,1637720556,15
580,8,87,1649538589,2802,1649541391,50
581,25,74,1629796272,1685,1629797957,40
582,49,92,1639350726,4198,1639354924,21
583,36,80,1636873386,2514,1636875900,15
584,41,84,1642913591,3595,1642917186,19
585,17,80,1658571158,488,1658571646,32
586,35,63,1645106501,4865,1645111366,40
587,50,81,1636904390,2136,1636906526,16
588,8,56,1643324932,825,1643325757,10
589,47,64,1652685831,1482,1652687313,28
590,48,55,1634611644,2433,1634614077,18
591,17,99,1631696126,1616,1631697742,8
592,39,60,1635555162,484,1635555646,38
593,41,95,1630195271,3331,1630198602,1
594,48,69,1637981593,1061,1637982654,30
595,40,80,1646892337,4367,1646896704,16
596,39,62,1659796160,3437,1659799597,35
597,46,86,1651009771,4556,1651014327,6
598,48,63,1660008076,1570,1660009646,21
599,3,96,1633072204,4461,1633076665,42
600,18,91,1657681753,2882,1657684635,42
601,38,89,1647275827,1904,1647277731,33
602,17,81,1657890453,488,1657890941,49
603,8,90,1642677857,2754,1642680611,38
604,44,57,1629827355,2955,1629830310,42
605,18,97,1657091838,3564,1657095402,26
606,35,80,1641076769,681,1641077450,10
607,47,82,1634945962,4464,1634950426,21
608,35,74,1653461943,3116,1653465059,35
609,50,80,1659159049,4068,1659163117,42
610,43,58,1639964409,4410,1639968819,2
611,31,89,1635331703,2822,1635334525,28
612,45,91,1654899695,1786,1654901481,36
613,25,69,1660082722,2165,1660084887,45
614,35,61,1636764518,2690,1636767208,38
615,12,91,1640396338,1325,1640397663,7
616,32,62,1659806774,425,1659807199,43
617,45,84,1645786274,902,1645787176,40
618,13,74,1655250687,361,1655251048,38
619,41,61,1657326053,3668,1657329721,37
620,5,84,1632342528,571,1632343099,10
621,36,78,1654109539,2852,1654112391,1
622,22,62,1647866981,1497,1647868478,21
623,18,71,1649350134,2331,1649352465,30
624,24,90,1647268316,2397,1647270713,41
625,8,65,1648548743,289,1648549032,26
626,28,88,1654236280,344,1654236624,43
627,50,90,1657322500,487,1657322987,30
628,50,61,1660099520,4599,1660104119,40
629,12,77,1657937547,296,1657937843,12
630,40,96,1644352673,4320,1644356993,13
631,2,92,1642625413,2393,1642627806,42
632,17,72,1652762392,737,1652763129,44
633,47,59,1633091870,3138,1633095008,34
634,40,59,1645070416,3785,1645074201,6
635,22,54,1650470653,3704,1650474357,49
636,29,67,1640924557,4087,1640928644,12
637,6,82,1643598502,1442,1643599944,10
638,50,84,1630710730,2452,1630713182,12
639,40,64,1632339882,1583,1632341465,15
640,5,57,1657086892,3118,1657090010,19
641,39,83,1632943049,3309,1632946358,26
642,4,61,1655222912,1447,1655224359,30
643,27,81,1652545956,1421,1652547377,39
644,13,88,1638801087,2084,1638803171,29
645,16,65,1643450518,182,1643450700,15
646,11,89,1647447408,2627,1647450035,29
647,22,80,1652732314,1536,1652733850,30
648,24,72,1643447013,1195,1643448208,33
649,42,56,1644384504,146,1644384650,29
650,10,80,1659192547,1968,1659194515,25
651,50,83,1660976771,2264,1660979035,33
652,15,94,1658768207,1447,1658769654,39
653,42,98,1656570996,4474,1656575470,16
654,4,66,1651833874,4484,1651838358,14
655,47,82,1638061840,2126,1638063966,33
656,49,78,1635901975,4116,1635906091,21
657,35,94,1642096440,523,1642096963,23
658,41,84,1632715244,1330,1632716574,20
659,47,88,1649339221,3597,1649342818,41
660,22,88,1640291685,612,1640292297,22
661,43,98,1648383942,707,1648384649,24
662,9,65,1639569589,521,1639570110,31
663,26,79,1652722010,2534,1652724544,10
664,27,98,1635166648,746,1635167394,20
665,40,84,1639394752,989,1639395741,5
666,17,51,1643481109,4943,1643486052,20
667,7,54,1644042799,2470,1644045269,8
668,29,57,1644626409,1614,1644628023,14
669,12,63,1640351954,170,1640352124,49
670,20,52,1640414597,4115,1640418712,45
671,47,76,1658906087,403,1658906490,39
672,25,81,1639752659,3997,1639756656,8
673,6,54,1640255880,1361,1640257241,46
674,29,78,1652719843,384,1652720227,14
675,22,94,1658170667,1261,1658171928,2
676,19,62,1659173600,4401,1659178001,18
677,22,83,1651695588,4024,1651699612,44
678,46,52,1656344098,2051,1656346149,16
679,50,75,1648571081,4644,1648575725,5
680,7,65,1648780283,2739,1648783022,33
681,19,70,1643319357,614,1643319971,14
682,28,52,1638100470,1048,1638101518,26
683,36,56,1635300751,3112,1635303863,45
684,25,80,1647931543,2264,1647933807,30
685,40,54,1658921470,3346,1658924816,28
686,33,89,1631929793,1007,1631930800,1
687,36,95,1639888854,1431,1639890285,22
688,16,81,1654840099,1466,1654841565,38
689,13,69,1659019982,4698,1659024680,31
690,20,86,1651522944,4624,1651527568,28
691,1,97,1658459979,1238,1658461217,38
692,31,81,1654890905,3468,1654894373,24
693,43,83,1642322108,3798,1642325906,48
694,37,85,1648447676,1967,1648449643,29
695,14,66,1659208549,3531,1659212080,16
696,20,92,1654807119,4411,1654811530,30
697,4,76,1640762565,3534,1640766099,37
698,41,62,1649789525,2998,1649792523,43
699,3,98,1658648007,4236,1658652243,40
700,48,77,1651128486,2626,1651131112,29
701,33,96,1644001106,2653,1644003759,4
702,3,55,1644202507,1332,1644203839,1
703,2,52,1644977323,4703,1644982026,4
704,20,96,1645099818,2332,1645102150,10
705,21,92,1652592424,3438,1652595862,28
706,36,87,1652909105,2496,1652911601,23
707,50,66,1634110233,4506,1634114739,46
708,37,51,1636064367,4838,1636069205,6
709,6,72,1656682678,4321,1656686999,2
710,28,62,1635463175,188,1635463363,30
711,22,57,1657730979,2974,1657733953,40
712,40,79,1656248603,930,1656249533,37
713,12,84,1636321738,2574,1636324312,12
714,14,66,1643135403,3414,1643138817,15
715,1,96,1629933676,3103,1629936779,25
716,7,57,1633972564,2290,1633974854,21
717,45,52,1660265162,2466,1660267628,48
718,10,71,1631930885,3286,1631934171,29
719,50,89,1644743422,3830,1644747252,10
720,19,77,1635007039,177,1635007216,2
721,1,86,1654955059,716,1654955775,42
722,1,97,1629742441,3666,1629746107,43
723,20,68,1647050261,3457,1647053718,19
724,35,93,1638964176,3212,1638967388,3
725,24,81,1652612784,4328,1652617112,33
726,40,88,1652236208,1544,1652237752,49
727,36,55,1635955740,1811,1635957551,1
728,24,71,1658641679,4662,1658646341,34
729,21,58,1637383425,3993,1637387418,25
730,31,52,1643331883,1677,1643333560,36
731,26,93,1630915659,209,1630915868,29
732,5,58,1644781197,180,1644781377,3
733,40,98,1634130399,1084,1634131483,5
734,2,97,1655499106,2994,1655502100,2
735,1,85,1635074224,276,1635074500,11
736,21,98,1660624918,4310,1660629228,23
737,33,68,1635637857,2575,1635640432,26
738,44,97,1640312383,4438,1640316821,1
739,46,92,1650293180,3164,1650296344,7
740,29,67,1630584242,1527,1630585769,49
741,25,97,1634093664,254,1634093918,8
742,3,69,1642512648,2004,1642514652,38
743,11,83,1655581021,1365,1655582386,6
744,6,72,1656059734,4547,1656064281,7
745,27,93,1655372888,4824,1655377712,33
746,13,62,1633546455,570,1633547025,32
747,35,84,1650539521,2726,1650542247,20
748,34,54,1642578009,4174,1642582183,43
749,37,84,1637104773,2179,1637106952,4
750,31,90,1658277056,4585,1658281641,11
751,34,87,1651138408,912,1651139320,14
752,2,72,1642018930,2093,1642021023,43
753,7,54,1648973730,1526,1648975256,44
754,14,64,1634548344,1213,1634549557,4
755,39,85,1657411331,4732,1657416063,8
756,22,51,1635279300,4280,1635283580,38
757,50,63,1630944662,2588,1630947250,43
758,11,82,1652789294,3109,1652792403,12
759,39,61,1656562940,4779,1656567719,29
760,11,64,1642119041,711,1642119752,42
761,34,57,1640257447,2538,1640259985,28
762,24,64,1657231917,1107,1657233024,20
763,11,91,1648796323,446,1648796769,42
764,40,86,1654726980,4677,1654731657,16
765,13,83,1630119677,3435,1630123112,25
766,10,80,1632851480,4136,1632855616,15
767,15,81,1636390980,4791,1636395771,30
768,49,56,1635254520,1465,1635255985,8
769,6,58,1635634025,535,1635634560,23
770,30,66,1630748052,1949,1630750001,43
771,44,93,1637207043,4110,1637211153,41
772,49,56,1651940342,1894,1651942236,26
773,27,72,1659941050,2599,1659943649,3
774,7,65,1645460975,1673,1645462648,12
775,50,66,1647138197,4673,1647142870,7
776,16,56,1659153766,1024,1659154790,9
777,23,60,1629836844,475,1629837319,27
778,21,76,1633816813,4084,1633820897,48
779,37,88,1645293215,1729,1645294944,13
780,39,70,1660261174,1553,1660262727,46
781,3,88,1653969792,979,1653970771,22
782,48,69,1639103803,1495,1639105298,7
783,21,78,1634239117,255,1634239372,13
784,27,94,1629642059,3471,1629645530,13
785,11,68,1642632348,928,1642633276,28
786,24,82,1651328008,1098,1651329106,11
787,33,61,1645145319,1664,1645146983,12
788,22,77,1656864670,1308,1656865978,34
789,33,70,1658288356,967,1658289323,16
790,7,97,1644939731,3897,1644943628,14
791,11,77,1649959055,3837,1649962892,30
792,3,68,1641914780,1200,1641915980,45
793,28,74,1635095812,2088,1635097900,28
794,32,85,1631695349,2423,1631697772,21
795,2,65,1660725668,4014,1660729682,40
796,27,79,1635517805,2795,1635520600,37
797,48,61,1649484155,1775,1649485930,29
798,31,69,1650986892,597,1650987489,32
799,48,75,1638948801,224,1638949025,47
800,39,93,1650837493,2052,1650839545,8
801,9,97,1645568337,4615,1645572952,11
802,43,68,1645036968,217,1645037185,19
803,35,70,1658562963,2198,1658565161,34
804,39,91,1645131770,153,1645131923,40
805,49,79,1660407084,4064,1660411148,45
806,36,70,1634453026,3620,1634456646,28
807,24,64,1646796094,1757,1646797851,48
808,40,82,1631241445,4292,1631245737,13
809,40,92,1635815133,1417,1635816550,17
810,18,58,1655897112,2742,1655899854,33
811,29,77,1632373444,3634,1632377078,25
812,42,63,1631290226,3450,1631293676,43
813,21,97,1645658050,1973,1645660023,42
814,1,68,1652336886,4189,1652341075,2
815,30,61,1651095518,601,1651096119,18
816,17,70,1649213606,2116,1649215722,11
817,9,63,1644103545,1415,1644104960,36
818,5,65,1652484509,4347,1652488856,15
819,29,54,1631146508,3285,1631149793,9
820,9,96,1641389773,993,1641390766,18
821,38,63,1651309884,3035,1651312919,49
822,28,78,1645160986,1958,1645162944,38
823,36,55,1644986194,1451,1644987645,41
824,9,91,1650491190,963,1650492153,26
825,12,98,1651762528,4602,1651767130,5
826,31,88,1646177493,4301,1646181794,29
827,48,98,1637368220,3116,1637371336,31
828,23,69,1654042993,3867,1654046860,30
829,6,75,1637604987,3682,1637608669,1
830,43,75,1631230785,3250,1631234035,35
831,28,66,1630023361,994,1630024355,9
832,28,51,1645242053,3900,1645245953,1
833,18,70,1645355485,4008,1645359493,19
834,7,90,1648779612,356,1648779968,16
835,19,53,1658260076,2585,1658262661,13
836,50,55,1655011889,2516,1655014405,49
837,25,92,1643152576,1026,1643153602,10
838,24,59,1646822456,1230,1646823686,28
839,4,94,1645927445,1124,1645928569,21
840,12,80,1657316716,115,1657316831,39
841,29,73,1631723501,1007,1631724508,18
842,32,78,1632929218,4424,1632933642,15
843,24,58,1632784255,591,1632784846,18
844,9,95,1635840951,1710,1635842661,35
845,44,97,1632688843,3265,1632692108,20
846,26,89,1652804253,2313,1652806566,23
847,33,62,1640476655,2363,1640479018,27
848,19,95,1648340330,2465,1648342795,34
849,33,60,1641655287,723,1641656010,32
850,36,84,1660992267,4697,1660996964,25
851,33,68,1629603511,3638,1629607149,4
852,34,91,1635636440,382,1635636822,4
853,44,70,1655406398,738,1655407136,29
854,16,81,1651034882,3451,1651038333,23
855,36,67,1638749978,1596,1638751574,41
856,36,91,1647195832,2341,1647198173,12
857,41,93,1660873352,4522,1660877874,4
858,13,88,1649744389,2321,1649746710,23
859,44,90,1645629787,4138,1645633925,36
860,49,78,1639542412,3188,1639545600,22
861,47,77,1642718322,2258,1642720580,13
862,50,88,1637972294,3582,1637975876,15
863,50,72,1639879459,4172,1639883631,27
864,38,86,1649295761,1462,1649297223,24
865,28,53,1636917096,3279,1636920375,37
866,33,83,1642885292,2621,1642887913,40
867,13,78,1655201191,3678,1655204869,32
868,36,60,1647885943,4543,1647890486,6
869,41,67,1647086073,4170,1647090243,1
870,7,84,1644768740,2048,1644770788,1
871,7,98,1634504906,3833,1634508739,9
872,7,61,1645685947,3677,1645689624,7
873,15,77,1647517828,4051,1647521879,39
874,36,76,1637662715,4881,1637667596,1
875,9,64,1656487782,3535,1656491317,6
876,47,95,1657927338,3443,1657930781,29
877,8,72,1660876618,735,1660877353,30
878,47,53,1636729498,1075,1636730573,21
879,13,55,1644446513,2284,1644448797,44
880,4,64,1644854842,2455,1644857297,9
881,1,84,1632838985,2025,1632841010,29
882,20,98,1646718449,3012,1646721461,3
883,18,57,1654379759,3039,1654382798,11
884,35,54,1638005817,3078,1638008895,46
885,23,76,1647484718,3517,1647488235,39
886,20,95,1644218479,4918,1644223397,10
887,9,72,1647625834,3289,1647629123,35
888,44,70,1639222133,1618,1639223751,16
889,10,58,1640596903,2891,1640599794,32
890,13,96,1638894992,4982,1638899974,44
891,19,97,1642056621,920,1642057541,31
892,11,68,1661021170,628,1661021798,4
893,42,83,1632528534,2257,1632530791,28
894,27,52,1643899683,3864,1643903547,40
895,23,99,1644529459,583,1644530042,1
896,35,92,1650085800,1148,1650086948,15
897,19,68,1638447669,3347,1638451016,28
898,41,86,1641386569,3146,1641389715,49
899,48,71,1640670183,1288,1640671471,11
900,10,52,1632846067,1956,1632848023,22
901,47,57,1652480013,4317,1652484330,27
902,41,74,1640167649,301,1640167950,45
903,45,71,1654021881,172,1654022053,20
904,10,63,1645161272,208,1645161480,22
905,6,54,1642741167,702,1642741869,13
906,25,88,1631841208,3824,1631845032,39
907,8,83,1634115667,4259,1634119926,42
908,22,85,1634904750,1107,1634905857,39
909,15,89,1632905086,3621,1632908707,43
910,12,67,1632588045,3159,1632591204,37
911,7,84,1633722082,619,1633722701,20
912,10,72,1643915584,4268,1643919852,3
913,29,76,1654553661,1766,1654555427,23
914,20,69,1658531678,2265,1658533943,35
915,36,62,1639977493,3134,1639980627,11
916,17,89,1656710434,1290,1656711724,15
917,15,53,1636599682,4131,1636603813,6
918,21,84,1654263950,4660,1654268610,38
919,18,77,1637127133,1783,1637128916,40
920,25,76,1638610250,3213,1638613463,15
921,6,64,1637253379,754,1637254133,13
922,5,84,1636629954,1036,1636630990,13
923,31,97,1632007402,4918,1632012320,32
924,39,91,1641222549,2647,1641225196,35
925,3,92,1638726747,3669,1638730416,31
926,32,61,1646651712,2967,1646654679,20
927,10,93,1629644651,4273,1629648924,13
928,24,96,1646758672,2866,1646761538,8
929,13,68,1651424955,2134,1651427089,48
930,47,99,1660360311,4004,1660364315,31
931,9,92,1634818915,1636,1634820551,46
932,45,90,1655529065,3135,1655532200,19
933,38,73,1636346811,3614,1636350425,38
934,8,99,1632252341,549,1632252890,15
935,24,58,1653041852,830,1653042682,25
936,16,62,1655275732,1700,1655277432,32
937,43,65,1636444590,3265,1636447855,23
938,48,86,1631181230,122,1631181352,7
939,42,85,1649456240,219,1649456459,8
940,38,80,1631567171,106,1631567277,41
941,1,64,1649715039,4254,1649719293,25
942,18,85,1646058408,1706,1646060114,34
943,23,87,1649367016,4989,1649372005,32
944,32,59,1655871563,1423,1655872986,13
945,11,83,1660599538,2780,1660602318,29
946,38,89,1634210031,1719,1634211750,44
947,25,90,1640649088,1716,1640650804,15
948,48,87,1654646484,3074,1654649558,30
949,6,54,1635145297,523,1635145820,2
950,23,77,1635528747,3943,1635532690,17
951,7,66,1635933291,690,1635933981,20
952,50,86,1640685898,2394,1640688292,40
953,36,75,1642370879,3349,1642374228,46
954,48,73,1656782061,398,1656782459,37
955,14,53,1642198196,4353,1642202549,46
956,11,80,1657355720,2111,1657357831,9
957,23,97,1660805091,4602,1660809693,14
958,50,98,1655250174,4714,1655254888,9
959,29,68,1633499373,3345,1633502718,48
960,14,95,1649992084,1079,1649993163,46
961,6,66,1650017350,1418,1650018768,22
962,18,98,1632992171,450,1632992621,19
963,5,89,1652032527,1970,1652034497,37
964,37,55,1651173322,1902,1651175224,20
965,39,83,1634411290,3877,1634415167,48
966,9,52,1660208750,3862,1660212612,32
967,8,84,1636854273,1219,1636855492,35
968,20,88,1652306527,102,1652306629,17
969,17,82,1638024256,665,1638024921,36
970,44,80,1653447120,739,1653447859,4
971,1,62,1648251690,3779,1648255469,36
972,49,59,1649956886,255,1649957141,45
973,15,64,1652351728,871,1652352599,8
974,27,90,1654687429,2560,1654689989,36
975,48,96,1631809371,2397,1631811768,30
976,41,77,1650373218,2786,1650376004,21
977,5,81,1651353254,2362,1651355616,37
978,24,76,1647159911,1464,1647161375,20
979,49,57,1646133130,2074,1646135204,35
980,9,92,1633885798,4054,1633889852,30
981,41,86,1652951666,1559,1652953225,47
982,6,99,1650152132,3477,1650155609,27
983,43,84,1649401695,585,1649402280,32
984,12,55,1654148947,372,1654149319,46
985,33,79,1645578504,671,1645579175,38
986,10,70,1632712737,120,1632712857,42
987,9,55,1648378985,359,1648379344,8
988,37,68,1637855297,3952,1637859249,35
989,9,79,1647928825,950,1647929775,22
990,11,84,1650369481,1961,1650371442,26
991,15,58,1645181008,4306,1645185314,7
992,31,68,1651528070,461,1651528531,42
993,38,73,1632046926,369,1632047295,40
994,9,60,1630657250,1585,1630658835,41
995,6,65,1658763166,107,1658763273,26
996,20,58,1646919341,2905,1646922246,30
997,41,87,1657743229,510,1657743739,26
998,41,86,1658778455,3944,1658782399,44
999,35,82,1630370931,1357,1630372288,12
1000,24,64,1656883190,3581,1656886771,42
